R 960 600
NO ./textures/path_to_the_north_texture
SO ./textures/path_to_the_south_texture
WE ./textures/path_to_the_west_texture
EA ./textures/path_to_the_east_texture

S ./textures/path_to_the_sprite_texture
F 102,51,0
C 51,204,204

11111111111111
10601070000001
10004060006001
1N001000200001
11111131111111
10070000200001
10060000000001
11111111111111
