R 640 480
NO ./textures/path_to_the_west_texture
SO ./textures/path_to_the_south_texture
WE ./textures/path_to_the_west_texture
EA ./textures/path_to_the_east_texture

S ./textures/path_to_the_sprite_texture
F 100,100,250
C 225,30,0

   11111111111111
   10001000000001
   10000010002001
   1E001000200001
  1111110111111111
  10020000200001
  10000000000001
  11111111111111
