R 640 480
NO ./textures/path_to_the_north_texture
SO ./textures/path_to_the_south_texture
WE ./textures/path_to_the_west_texture
EA ./textures/path_to_the_east_texture

S ./textures/path_to_the_sprite_texture
F 102,51,0
C 51,204,204

        1111111111111111111111111
        1000000000000000000000001
        1100030000000000000000001
        1000000003000000000000001
111111111000000000000000000000001
100000000000700002000000000001111
10000000600000E00000000000001
10000000002000000000000000001
10000000000000700000000000001
10000000000003000000000000001
10000000000000000001010000001
11000001110101011111011110101
11110111 1110121 101111010001
11111111 1111111 111111111111
