R 600 600
NO ./textures/path_to_the_north_texture
SO ./textures/path_to_the_south_texture
WE ./textures/path_to_the_west_texture
EA ./textures/path_to_the_east_texture

S ./textures/path_to_the_sprite_texture
F 102,51,0
C 51,204,204

11111111111111
10601070070001
10004060206001
1N003067002001
11111111111111
